70 80
0000000000000000000000000000000000000000000000000000000000000000000000
0000000000000000000000000000000000000000000000000000000000000000000000
0000000000000000000000000000000000000000000000000000000000000000000000
0000000000000000000000000000000000000000000000000000000000000000000000
0000000000000000000000000000000000000000000000000000000000000000000000
0000000000000000000000000000000000000000000000000000000000000000000000
0000000000000000000000000000000000000000000000000000000000000000000000
0000000000000000000000000000000000000000000000000000000000000000000000
0000000000000000000000000000000000000000000000000000000000000000000000
0000000000000000000000000000000000000000000000000000000000000000000000
0000000000000000000000000000000000000000000000000000000000000000000000
0000000000000000000000000000000000000000000000000000000000000000000000
0000000000000000000000000000000000000000000000000000000000000000000000
0000000000000000000000000000000000000000000000000000000000000000000000
0000000000000000000000000000000000000000000000000000000000000000000000
0000000000000000000000000000000000000000000000000000000000000000000000
0000000000000000000000000000000000000000000000000000000000000000000000
0000000000000000000000000000000000000000000000000000000000000000000000
0000000000000000000000111111111111100000000000000000000000000000000000
0000000000000000000011000000000000011000000000000000000000000000000000
0000000000000000001100111000000011100110000000000000000000000000000000
0000000000000000110000000000000000000001100000000000000000000000000000
0000000000000001000000000000000000000000010000000000000000000000000000
0000000000000010000011111111111111111000001000000000000000000000000000
0000000000000100000010000000000000001000000100000000000000000000000000
0000000000001000000010000000000000001000000010000000000000000000000000
0000000000001000111111111111111111001000000010000000000000000000000000
0000000000010000000010000000000000001000000001000000000000000000000000
0000000000010000000010000000000000001000000001000000000000000000000000
0000000000100000000010000111111111111111110000100000000000000000000000
0000000000100000000010000100000000000000000000100000000000000000000000
0000000000100000000010000100000000000000000000100000000000000000000000
0000000001000001111111111110000000000000000000010000000000000000000000
0000000001000000000000000010000000000000000000010000000000000000000000
0000000001000000000000000010000000000000000000010000000000000000000000
0000000001000000000000000011111111111111111100010000000000000000000000
0000000001000000000000000000000000000000000010010000000000000000000000
0000000001000000000000000000000000000000000010010000000000000000000000
0000000001000000111111111100000000000000001000010000000000000000000000
0000000001000000100000001111111110000000001000010000000000000000000000
0000000001000000100000000000000000000000001000010000000000000000000000
0000000000100000100000000000000000011111111110100000000000000000000000
0000000000100000100000000003000000010000000000100000000000000000000000
0000000000100000100000000000000000010000000000100000000000000000000000
0000000000010000111100001111111111110000000001000000000000000000000000
0000000000010000000000000000000000010000000001000000000000000000000000
0000000000001000000000000000000000010000000010000000000000000000000000
0000000000001000000111111111110011110000000010000000000000000000000000
0000000000000100000100000000000000000000000100000000000000000000000000
0000000000000100000100000000000000000000000100000000000000000000000000
0000000000000010000100000111111111111111111000000000000000000000000000
0000000000000001000100000000000000000000010000000000000000000000000000
0000000000000000100100000000000000000000100000000000000000000000000000
0000000000000000011111111111000030000011000000000000000000000000000000
0000000000000000000110000000000000001100000000000000000000000000000000
0000000000000000000001000000000000010000000000000000000000000000000000
0000000000000000000000110000111111100000000000000000000000000000000000
0000000000000000000001110000111001111000000000000000000000000000000000
0000000000000000000001000000000000001000000000000000000000000000000000
0000000000000000000001000000000000001000000000000000000000000000000000
0000000000000000000001111111100001111000000000000000000000000000000000
0000000000000000000001000000000000001000000000000000000000000000000000
0000000000000000000001000000000000001000000000000000000000000000000000
0000000000000000000001000000011111111000000000000000000000000000000000
0000000000000000000001000000000000001000000000000000000000000000000000
0000000000000000000001000000000000000000000000000000000000000000000000
0000000000000000000001111111110000000000000000000000000000000000000000
0000000000000000000001000000000000000000000000000000000000000000000000
0000000000000000000001000000000000000000000000000000000000000000000000
0000000000000000000001000000011111111100000000000000000000000000000000
0000000000000000000001000000000000001000000000000002000000000000000000
0000000000000000000001000000000000001000000000000000000000000000000000
0000000000000000001111111111111111111110000000000000000000000000000000
1111111111111111111111111111111111111111111111111111111111111111111111
0000000000000000000000000000000000000000000000000000000000000000000000
0000000000000000000000000000000000000000000000000000000000000000000000
0000000000000000000000000000000000000000000000000000000000000000000000
0000000000000000000000000000000000000000000000000000000000000000000000
0000000000000000000000000000000000000000000000000000000000000000000000
0000000000000000000000000000000000000000000000000000000000000000000000