120 120
000000000000000000000000000000000000000000000000000000000000000000000000000000000000000000000000000000000000000000000000
000000000000000000000000000000000000000000000000000000000000000000000000000000000000000000000000000000000000000000000000
000000000000000000000000000000000000000000000000000000000000000000000000000000000000000000000000000000000000000000000000
000000000000000000000000000000000000000000000000000000000000000000000000000000000000000000000000000000000000000000000000
000000000000000000000000000000000000000000000000000000000000000000000000000000000000000000000000000000000000000000000000
000000000000000000000000000000000000000000000000000000000000000000000000000000000000000000000000000000000000000000000000
000000000000000000000000000000000000000000000000000111111111100000000000000000000000000000000000000000000000000000000000
000000000000000000000000000000000000000000000011111111111111111110000000000000000000000000000000000000000000000000000000
000000000000000000000000000000000000000000011111111111111111111111110000000000000000000000000000000000000000000000000000
000000000000000000000000000000000000000001111111111101110000111111111100000000000000000000000000000000000000000000000000
000000000000000000000000000000000000000111111111000001110000000001111111000000000000000000000000000000000000000000000000
000000000000000000000000000000000000011111111000000001110000000000011111110000000000000000000000000000000000000000000000
000000000000000000000000000000000000111111100000000001110000000000000011111000000000000000000000000000000000000000000000
000000000000000000000000000000000001111110000000000001110000000000000001111100000000000000000000000000000000000000000000
000000000000000000000000000000000111111000000000000001110000000000000000011111000000000000000000000000000000000000000000
000000000000000000000000000000001111110000000000000001110000000000000000001111100000000000000000000000000000000000000000
000000000000000000000000000000011111100000000000000001110000000000000000000111110000000000000000000000000000000000000000
000000000000000000000000000000111111000000000000000001110000000000000000000001110000000000000000000000000000000000000000
000000000000000000000000000001111110000000000000000001110000000000000000000000111000000000000000000000000000000000000000
000000000000000000000000000001111100000000000000000001110000000000000000000000111100000000000000000000000000000000000000
000000000000000000000000000011111000000000000000000001110000000000000000000000011110000000000000000000000000000000000000
000000000000000000000000000111110000000000011111111111111111111111000000000000001110000000000000000000000000000000000000
000000000000000000000000000111110000000000111111111111111111111111000000000000000111000000000000000000000000000000000000
000000000000000000000000001111100000000000011100000000000000000001000000000000000111100000000000000000000000000000000000
000000000000000000000000001111100000000000011100000000000000000001000000000000000011100000000000000000000000000000000000
000000000000000000000000011111000000000000011100000000000000000001000000000000000001110000000000000000000000000000000000
000000000000000000000000011111000000000000011100000000000000000001000000000000000001110000000000000000000000000000000000
000000000000000000000000111110000000000000011100000000000000000001000000000000000001111000000000000000000000000000000000
000000000000000000000000111110000000000000011100000000000000000001000000000000000000111000000000000000000000000000000000
000000000000000000000000111100000000000000011100000000000000000001000000000000000000111000000000000000000000000000000000
000000000000000000000001111100000000000000011100000000000000000001000000000000000000011100000000000000000000000000000000
000000000000000000000001111100000000000000011100000000000000000001000000000000000000011100000000000000000000000000000000
000000000000000000000001111100000000000000011100000000000000000001000000000000000000011100000000000000000000000000000000
000000000000000000000001111100000000000000011100000000000000111111110001111111111111111100000000000000000000000000000000
000000000000000000000011111111111111111111111100000000000001111111111111111111111111111110000000000000000000000000000000
000000000000000000000011111000000000011111000000000000000001110000000000000000000000001110000000000000000000000000000000
000000000000000000000011011000000000001110000000000000000001100000000000000000000000001110000000000000000000000000000000
000000000000000000000011011000000000001110000000000000000001100000000000000000000000001110000000000000000000000000000000
000000000000000000000011011000000000001110000000000000000001100000000000000000000000001110000000000000000000000000000000
000000000000000000000011011000000000001110000000000000000001100000000000000000000000001110000000000000000000000000000000
000000000000000000000011011000000000001110000000000000000001100000000000000000000000001110000000000000000000000000000000
000000000000000000000011011000000000001110000000000000000001100000000000000000000000001110000000000000000000000000000000
000000000000000000000011011000000000001110000000000000000001100000000000000000000000001110000000000000000000000000000000
000000000000000000000011011000000000001110000000000000000001100000000000000000000000001110000000000000000000000000000000
000000000000000000000011011000000000001110000000000000000001100000000000000000000000001110000000000000000000000000000000
000000000000000000000011101000000000001110000000000000000001100000000000000000000000001110000000000000000000000000000000
000000000000000000000001101111111111111111111111111111111111111111111110000000000000011110000000000000000000000000000000
000000000000000000000001111111111111111111111111111111111111111111111110000000000000011100000000000000000000000000000000
000000000000000000000001111111111111111111111111111111111111111111111110000000000000011100000000000000000000000000000000
000000000000000000000001110110000000000000000001110000000000000000000010000000000000111100000000000000000000000000000000
000000000000000000000000110110000000000000000001110000000000000000000010000000000000111100000000000000000000000000000000
000000000000000000000000110110000000000000000001110000000000000000000010000000000000111000000000000000000000000000000000
000000000000000000000000111011000000000000000001110000000000000000000010000000000001111000000000000000000000000000000000
000000000000000000000000011011000000000000000001110000000000000000000010000000000001111000000000000000000000000000000000
000000000000000000000000011001100000000000000001110000000000000000000010000000000011110000000000000000000000000000000000
000000000000000000000000001101110000000000000001110000000000000000000010000000000011110000000000000000000000000000000000
000000000000000000000000001110110000000000000001110000000000000000000010000000000111100000000000000000000000000000000000
000000000000000000000000000110111000000000000001111111111111111111111111111111111111100000000000000000000000000000000000
000000000000000000000000000111011100000000000001111111111111111111111111111111111111000000000000000000000000000000000000
000000000000000000000000000011101100000000000001111111111111111111111111111111111110000000000000000000000000000000000000
000000000000000000000000000001100110000000000001111111111111111111111111111111111110000000000000000000000000000000000000
000000000000000000000000000001111111000000000001110000000000000000000000000001111100000000000000000000000000000000000000
000000000000000000000000000000111111100000000001110000000000000000000000000011111000000000000000000000000000000000000000
000000000000000000000000000000111111111000000001110000000000000000000000000111111000000000000000000000000000000000000000
000000000000000000000000000000111111111100000001110000000000000000000000011111111000000000000000000000000000000000000000
000000000000000000000000000000111111111111000001110000000000000000000000111111111000000000000000000000000000000000000000
000000000000000000000000000000011111111111100000110000000000000000000011111111110000000000000000000000000000000000000000
000000000000000000000000000000001101111111111000110000000000000000001111111111110000000000000000000000000000000000000000
000000000000000000000000000000001011111111111111110000000000000000111111111111110000000000000000000000000000000000000000
000000000000000000000000000000001110111111101111111100000000000111111111111111110000000000000000000000000000000000000000
000000000000000000000000000000000110011111111001111111111111111111111111111011100000000000000000000000000000000000000000
000000000000000000000000000000000011111111111111111111111111111111111111111111000000000000000000000000000000000000000000
000000000000000000000000000000000011110101111111111111111111111111111111101111000000000000000000000000000000000000000000
000000000000000000000000000000000001110111111111111111111111111111111111101110000000000000000000000000000000000000000000
000000000000000000000000000000000000000111111111111111111111111111111111111100000000000000000000000000000000000000000000
000000000000000000000000000000000000000011111111111111111111111111111111000000000000000000000000000000000000000000000000
000000000000000000000000000000000000000011111111111111111111111111111111000000000000000000000000000000000000000000000000
000000000000000000000000000000000000000011111111111111111111111111111111000000000000000000000000000000000000000000000000
000000000000000000000000000000000000000111111111111111111111111111111111000000000000000000000000000000000000000000000000
000000000000000000000000000000000000000111111111111111111111111111111111110000000000000000000000000000000000000000000000
000000000000000000000000000000000000000111111111111111111111111111111111010000000000000000000000000000000000000000000000
000000000000000000000000000000000000001111111111111111111111111111111111011000000000000000000000000000000000000000000000
000000000000000000000000000000000000011111111111111111111111111111111111111000000000000000000000000000000000000000000000
000000000000000000000000000000000000011110000000000000000000001110000111111000000000000000000000000000000000000000000000
000000000000000000000000000000000000011100000000000000000000000100000000011000000000000000000000000000000000000000000000
000000000000000000000000000000000000011100000000000000000000000100000000011000000000000000000000000000000000000000000000
000000000000000000000000000000000000011100000000000000000000000100000000011000000000000000000000000000000000000000000000
000000000000000000000000000000000000011100000000000000000000000100000000011000000000000000000000000000000000000000000000
000000000000000000000000000000000000011100000000000111111111111100000000011000000000000000000000000000000000000000000000
000000000000000000000000000000000000011110000000001111111111111100000000011000000000000000000000000000000000000000000000
000000000000000000000000000000000000011110000000001111111111111100000000011000000000000000000000000000000000000000000000
000000000000000000000000000000000000011110000000011111111111111100000000011000000000000000000000000000000000000000000000
000000000000000000000000000000000000011110000000011111111111111100000000011000000000000000000000000000000000000000000000
000000000000000000000000000000000000011110000000011111111111111110000000011000000000000000000000000000000000000000000000
000000000000000000000000000000000000011011111111111100000000000111111111111110000000000000000000000000000000000000000000
000000000000000000000000000000000000111111111111111100000000000111111111111110000000000000000000000000000000000000000000
000000000000000000000000000000000000111111111111111100000000000111111111111110000000000000000000000000000000000000000000
000000000000000000000000000000000001111111111111111100000000000111111111111110000000000000000000000000000000000000000000
000000000000000000000000000000000001111111111111111100000000000111111111111110000000000000000000000000000000000000000000
000000000000000000000000000000000001111111111111111100000000000111111111111111000000000000000000000000000000000000000000
000000000000000000000000000000000001010000000000011100000000000000000000000011000000000000000000000000000000000000000000
000000000000000000000000000000000001110000000000011100000000000000000000000010000000000000000000000000000000000000000000
000000000000000000000000000000000001110000000000011100000000000000000000000010000000000000000000000000000000000000000000
000000000000000000000000000000000001010000000000011100000000000000000000000010000000000000000000000000000000000000000000
000000000000000000000000000000000001110000000000011100000000000000000000000010000000000000000000000000000000000000000000
000000000000000000000000000000000001111100000000011110111111111111111110000110000000000000000000000000000000000000000000
000000000000000000000000000000000001101111111111111111111111111111111111111110000000000000000000000000000000000000000000
000000000000000000000000000000000001111111111111111111111111111111111111111110000000000000000000000000000000000000000000
000000000000000000000000000000000001111111111111111111111111111111111111111110000000000000000000000000000000000000000000
000000000000000000000000000000000001111111111111111111111111111111111111111110000000000000000000000000000000000000000000
000000000000000000000000000000000001111111111111111111111111111111111111111110000000000000000000000000000000000000000000
000000000000000000000000000000000001111111111111111111111111111111111111111110000000000000000000000000000000000000000000
000000000000000000000000000000000001100000000000000000011000000000000000000110000000000000000000000000000000000000000000
000000000000000000000000000000000000100000000000000000001000000000000000000110000000000000000000000000000000000000000000
000000000000000000000000000000000000000000000000000000000000000000000000000000000000000000000000000000000000000000000000
000000000000000000000000000000000000000000000000000000000000000000000000000000000000000000000000000000000000000000000000
000000000000000000000000000000000000000000000000000000000000000000000000000000000000000000000000000000000000000000000000
000000000000000000000000000000000000000000000000000000000000000000000000000000000000000000000000000000000000000000000000
000000000000000000000000000000000000000000000000000000000000000000000000000000000000000000000000000000000000000000000000
000000000000000000000000000000000000000000000000000000000000000000000000000000000000000000000000000000000000000000000000