75 75
000000000000000000000000000000000000000000000000000000000000000000000000000
000000000000000000000000000000000000000000000000000000000000000000000000000
000000000000000000000000000000000000000000000000000000000000000000000000000
000000000000000000000000000000000000000000000000000000000000000000000000000
000000000000000000000000000001111111111100000000000000000000000000000000000
000000000000000000000000001111111111111111100000000000000000000000000000000
000000000000000000000000111111000110000011111000000000000000000000000000000
000000000000000000000001111000000110000000011100000000000000000000000000000
000000000000000000000011110000000110000000000111000000000000000000000000000
000000000000000000001111000000000110000000000011100000000000000000000000000
000000000000000000011110000000000110000000000001110000000000000000000000000
000000000000000000111100000000000110000000000000111000000000000000000000000
000000000000000000111000000000000110000000000000011100000000000000000000000
000000000000000001110000000111111111111110000000001100000000000000000000000
000000000000000011110000000110000000000010000000000110000000000000000000000
000000000000000011100000000110000000000010000000000110000000000000000000000
000000000000000111100000000110000000000010000000000011000000000000000000000
000000000000000111000000000110000000000010000000000011000000000000000000000
000000000000000111000000000110000000000010000000000001100000000000000000000
000000000000001110000000000110000000000010000000000001100000000000000000000
000000000000001110000000000110000000000011000000000001100000000000000000000
000000000000001111111111111110000000011111111111111111100000000000000000000
000000000000001110000001110000000000010000000000000000100000000000000000000
000000000000001110000000110000000000010000000000000000110000000000000000000
000000000000001110000000110000000000010000000000000000110000000000000000000
000000000000001110000000110000000000010000000000000000110000000000000000000
000000000000001110000000110000000000010000000000000000110000000000000000000
000000000000001110000000110000000000010000000000000000110000000000000000000
000000000000001110000000110000000000010000000000000001100000000000000000000
000000000000001111111111111111111111111111110000000001100000000000000000000
000000000000001111111111111111111111111111111000000001100000000000000000000
000000000000000101000000000001100000000000001000000001100000000000000000000
000000000000000111100000000001100000000000001000000011000000000000000000000
000000000000000110100000000000100000000000011000000011000000000000000000000
000000000000000010110000000000100000000000011000000111000000000000000000000
000000000000000011010000000000100000000000011000001110000000000000000000000
000000000000000001111000000000111111111111111111111110000000000000000000000
000000000000000000101100000000111111111111111111111100000000000000000000000
000000000000000000111110000000100000000000000000111000000000000000000000000
000000000000000000011111000000100000000000000001111000000000000000000000000
000000000000000000011111100000100000000000000011111000000000000000000000000
000000000000000000011111111000100000000000001111110000000000000000000000000
000000000000000000001111011111100000000000110001110000000000000000000000000
000000000000000000001111001111110000000111110011100000000000000000000000000
000000000000000000000111000111111111111111000111100000000000000000000000000
000000000000000000000011100000000000000000001111000000000000000000000000000
000000000000000000000000111000000000000000011110000000000000000000000000000
000000000000000000000000011111111100000000011000000000000000000000000000000
000000000000000000000000011000000000000000011000000000000000000000000000000
000000000000000000000000111000000000000000011100000000000000000000000000000
000000000000000000000000110000011111111111001100000000000000000000000000000
000000000000000000000001111100011111111111111110000000000000000000000000000
000000000000000000000001100000000000000100000110000000000000000000000000000
000000000000000000000001100000000000000100000010000000000000000000000000000
000000000000000000000001100000000000000100000010000000000000000000000000000
000000000000000000000001100000001111111100000010000000000000000000000000000
000000000000000000000001100000011111111100000010000000000000000000000000000
000000000000000000000001100000011111111100000010000000000000000000000000000
000000000000000000000001110000011011011110000110000000000000000000000000000
000000000000000000000001111111110000000111111111000000000000000000000000000
000000000000000000000011111111110000000111111111000000000000000000000000000
000000000000000000000011111111110000000111111111000000000000000000000000000
000000000000000000000011000000010000000000000001000000000000000000000000000
000000000000000000000011000000010000000000000001000000000000000000000000000
000000000000000000000011000000010000000000000001000000000000000000000000000
000000000000000000000011000000010000000000000001000000000000000000000000000
000000000000000000000011111111111111111111111111000000000000000000000000000
000000000000000000000011111111111111111111111111000000000000000000000000000
000000000000000000000011111111111111111111111111000000000000000000000000000
000000000000000000000011111111111111111111111111000000000000000000000000000
000000000000000000000010000000000011000000000001000000000000000000000000000
000000000000000000000000000000000000000000000000000000000000000000000000000
000000000000000000000000000000000000000000000000000000000000000000000000000
000000000000000000000000000000000000000000000000000000000000000000000000000
000000000000000000000000000000000000000000000000000000000000000000000000000
