150 84
000000000000000000000000000000000000000000000000000000000000000000000000000000000000000000000000000000000000000000000000000000000000000000000000000000
000000000000000000000000000000000000000000000000000000000000000000000000000000000000000000000000000000000000000000000000000000000000000000000000000000
000000000000000000000000000000000000000000000000000000000000000000111111111000000000000000000000000000000000000000000000000000000000000000000000000000
000000000000000000000000000000000000000000000000000000000000001111111000111111100000000000000000000000000000000000000000000000000000000000000000000000
000000000000000000000000000000000000000000000000000000000000111100000000000000111100000000000000000000000000000000000000000000000000000000000000000000
000000000000000000000000000000000000000000000000000000000011100000000000000000001110000000000000000000000000000000000000000000000000000000000000000000
000000000000000000000000000000000000000000000000000000001110000000000000000000000011100000000000000000000000000000000000000000000000000000000000000000
000000000000000000000000000000000000000000000000000000011000000000000000000000000000110000000000000000000000000000000000000000000000000000000000000000
000000000000000000000000000000000000000000000000000000110000000000000000000000000000011100000000000000000000000000000000000000000000000000000000000000
000000000000000000000000000000000000000000000000000001100000000000000000000000000000000110000000000000000000000000000000000000000000000000000000000000
000000000000000000000000000000000000000000000000000011000000000000000000000000000000000011000000000000000000000000000000000000000000000000000000000000
000000000000000000000000000000000000000000000000000110000000000000000000000000000000000001000000000000000000000000000000000000000000000000000000000000
000000000000000000000000000000000000000000000000001100000000000000000000000000000000000001100000000000000000000000000000000000000000000000000000000000
000000000000000000000000000000000000000000000000011000000000011111111111111111100000000000110000000000000000000000000000000000000000000000000000000000
000000000000000000000000000000000000000000000000010000000000011000000000000001100000000000011000000000000000000000000000000000000000000000000000000000
000000000000000000000000000000000000000000000000110000000000010000000000000000100000000000011000000000000000000000000000000000000000000000000000000000
000000000000000000000000000000000000000000000000100000000000011000000000000000100000000000001100000000000000000000000000000000000000000000000000000000
000000000000000000000000000000000000000000000001100000000000011000000000000000100000000000001100000000000000000000000000000000000000000000000000000000
000000000000000000000000000000000000000000000001000000000000011000000000000000100000000000000110000000000000000000000000000000000000000000000000000000
000000000000000000000000000000000000000000000011000000000000011000000000000000100000000000000110000000000000000000000000000000000000000000000000000000
000000000000000000000000000000000000000000000011000000000000011000000000000000100000000000000010000000000000000000000000000000000000000000000000000000
000000000000000000000000000000000000000000000010000000000000011000000000000001100000000000000010000000000000000000000000000000000000000000000000000000
000000000000000000000000000000000000000000000011111111111100011000000000011111111111111111111111000000000000000000000000000000000000000000000000000000
000000000000000000000000000000000000000000000111111111111111110000000000011000000000000000000011000000000000000000000000000000000000000000000000000000
000000000000000000000000000000000000000000000110000000000010000000000000011000000000000000000001000000000000000000000000000000000000000000000000000000
000000000000000000000000000000000000000000000110000000000010000000000000011000000000000000000001000000000000000000000000000000000000000000000000000000
000000000000000000000000000000000000000000000110000000000010000000000000011000000000000000000001000000000000000000000000000000000000000000000000000000
000000000000000000000000000000000000000000000110000000000010000000000000011000000000000000000001000000000000000000000000000000000000000000000000000000
000000000000000000000000000000000000000000000110000000000010000000000000011000000000000000000001000000000000000000000000000000000000000000000000000000
000000000000000000000000000000000000000000000110000000000010000000000000011000000000000000000001000000000000000000000000000000000000000000000000000000
000000000000000000000000000000000000000000000110000000000010000000000000011000000000000000000001000000000000000000000000000000000000000000000000000000
000000000000000000000000000000000000000000000110000000000010000000000000011000000000000000000011000000000000000000000000000000000000000000000000000000
000000000000000000000000000000000000000000000011111111111111111110111111111111111100000000000011000000000000000000000000000000000000000000000000000000
000000000000000000000000000000000000000000000011111111111111111111111111111111111110000000000010000000000000000000000000000000000000000000000000000000
000000000000000000000000000000000000000000000011000000000000000001000000000000000110000000000010000000000000000000000000000000000000000000000000000000
000000000000000000000000000000000000000000000011000000000000000001000000000000000110000000000110000000000000000000000000000000000000000000000000000000
000000000000000000000000000000000000000000000001000000000000000001000000000000000110000000000100000000000000000000000000000000000000000000000000000000
000000000000000000000000000000000000000000000001100000000000000001000000000000000110000000001100000000000000000000000000000000000000000000000000000000
000000000000000000000000000000000000000000000000100000000000000001000000000000000110000000001100000000000000000000000000000000000000000000000000000000
000000000000000000000000000000000000000000000000110000000000000001000000000000000110000000011000000000000000000000000000000000000000000000000000000000
000000000000000000000000000000000000000000000000010000000000000001000000000000000110000000011000000000000000000000000000000000000000000000000000000000
000000000000000000000000000000000000000000000000011000000000000001111111111111111111111111110000000000000000000000000000000000000000000000000000000000
000000000000000000000000000000000000000000000000001100000000000001100000000000000000000001100000000000000000000000000000000000000000000000000000000000
000000000000000000000000000000000000000000000000000110000000000001000000000000000000000001000000000000000000000000000000000000000000000000000000000000
000000000000000000000000000000000000000000000000000011000000000001000000000000000000000011000000000000000000000000000000000000000000000000000000000000
000000000000000000000000000000000000000000000000000001100000000001000000000000000000000110000000000000000000000000000000000000000000000000000000000000
000000000000000000000000000000000000000000000000000000110000000001000000000000000000011100000000000000000000000000000000000000000000000000000000000000
000000000000000000000000000000000000000000000000000000011000000001000000000000000000110000000000000000000000000000000000000000000000000000000000000000
000000000000000000000000000000000000000000000000000000001110000001000000000000000011100000000000000000000000000000000000000000000000000000000000000000
000000000000000000000000000000000000000000000000000000000011100001000000000000001110000000000000000000000000000000000000000000000000000000000000000000
000000000000000000000000000000000000000000000000000000000000111101000000000000111000000000000000000000000000000000000000000000000000000000000000000000
000000000000000000000000000000000000000000000000000000000000111111111111111111111010000000000000000000000000000000000000000000000000000000000000000000
000000000000000000000000000000000000000000000000000000000011111111111111111111111110000000000000000000000000000000000000000000000000000000000000000000
000000000000000000000000000000000000000000000000000000000011000000000000000000000010000000000000000000000000000000000000000000000000000000000000000000
000000000000000000000000000000000000000000000000000000000011000000000000000000000010000000000000000000000000000000000000000000000000000000000000000000
000000000000000000000000000000000000000000000000000000000011000000000000000000000010000000000000000000000000000000000000000000000000000000000000000000
000000000000000000000000000000000000000000000000000000000011000000000000000000000010000000000000000000000000000000000000000000000000000000000000000000
000000000000000000000000000000000000000000000000000000000011000000000000000000000010000000000000000000000000000000000000000000000000000000000000000000
000000000000000000000000000000000000000000000000000000000111111111111111111111111111100000000000000000000000000000000000000000000000000000000000000000
000000000000000000000000000000000000000000000000000000000100000000000000000011000000100000000000000000000000000000000000000000000000000000000000000000
000000000000000000000000000000000000000000000000000000000100000000000000000010000000100000000000000000000000000000000000000000000000000000000000000000
000000000000000000000000000000000000000000000000000000000100000000000000000010000000100000000000000000000000000000000000000000000000000000000000000000
000000000000000000000000000000000000000000000000000000000100000000000000000010000000100000000000000000000000000000000000000000000000000000000000000000
000000000000000000000000000000000000000000000000000000000100000000000000000010000000100000000000000000000000000000000000000000000000000000000000000000
000000000000000000000000000000000000000000000000000000000100000000000000000010000000100000000000000000000000000000000000000000000000000000000000000000
000000000000000000000000000000000000000000000000000000000100000000111111111110000000100000000000000000000000000000000000000000000000000000000000000000
000000000000000000000000000000000000000000000000000000000100000000100000000010000000100000000000000000000000000000000000000000000000000000000000000000
000000000000000000000000000000000000000000000000000000000100000000100000000010000000100000000000000000000000000000000000000000000000000000000000000000
000000000000000000000000000000000000000000000000000000000100000000100000000010000000100000000000000000000000000000000000000000000000000000000000000000
000000000000000000000000000000000000000000000000000000001100000001100000000010000000100000000000000000000000000000000000000000000000000000000000000000
000000000000000000000000000000000000000000000000000000011111111111100000000011010001110000000000000000000000000000000000000000000000000000000000000000
000000000000000000000000000000000000000000000000000000010000000000100000000011111111111000000000000000000000000000000000000000000000000000000000000000
000000000000000000000000000000000000000000000000000000010000000000100000000000000000001000000000000000000000000000000000000000000000000000000000000000
000000000000000000000000000000000000000000000000000000010000000000100000000000000000001000000000000000000000000000000000000000000000000000000000000000
000000000000000000000000000000000000000000000000000000010000000000100000000000000000001000000000000000000000000000000000000000000000000000000000000000
000000000000000000000000000000000000000000000000000000010000000000100000000000000000001000000000000000000000000000000000000000000000000000000000000000
000000000000000000000000000000000000000000000000000000010000000000100000000000000000001000000000000000000000000000000000000000000000000000000000000000
000000000000000000000000000000000000000000000000000000010000000000100000000000000000001000000000000000000000000000000000000000000000000000000000000000
000000000000000000000000000000000000000000000000000000010000000000100000000000000000001000000000000000000000020000000000000000000000000000000000000000
000000000000000000000000000000000000000000000000000000011000000000100000000000000000001000000000000000000000000000000000000000000000000000000000000000
000000000000000000000000000000000000000000000000000000011111111111111111111111111111111000000000000000000000000000000000000000000000000000000000000000
000000000000000000000000000000000000000000000000000000010000000000000000000000000000001000000000000000000000000000000000000000000000000000000000000000
000000000000000000000000000000000111111111111111111111111111111111111111111111111111111111111111111111111111111111111111111111111110000000000000000000
000000000000000000000000000000000000000000000000000000000000000000000000000000000000000000000000000000000000000000000000000000000000000000000000000000
