130 73
0000000000000000000000000000000000000000000000000000000000000000000000000000000000000000000000000000000000000000000000000000000000
0000000000000000000000000000000000000000000000000000000000000000000000000000000000000000000000000000000000000000000000000000000000
0000000000000000000000000000000000000000000000000000000111111111111000000000000000000000000000000000000000000000000000000000000000
0000000000000000000000000000000000000000000000000000011110000000011111000000000000000000000000000000000000000000000000000000000000
0000000000000000000000000000000000000000000000000001110000000000000001110000000000000000000000000000000000000000000000000000000000
0000000000000000000000000000000000000000000000000110000000000000000000011000000000000000000000000000000000000000000000000000000000
0000000000000000000000000000000000000000000000001100000000000000000000000110000000000000000000000000000000000000000000000000000000
0000000000000000000000000000000000000000000000110000000000000000000000000011000000000000000000000000000000000000000000000000000000
0000000000000000000000000000000000000000000001100000000000000000000000000001100000000000000000000000000000000000000000000000000000
0000000000000000000000000000000000000000000011000000000000000000000000000000110000000000000000000000000000000000000000000000000000
0000000000000000000000000000000000000000000010000000000000000000000000000000011000000000000000000000000000000000000000000000000000
0000000000000000000000000000000000000000000100000000001111111111111100000000001100000000000000000000000000000000000000000000000000
0000000000000000000000000000000000000000001100000000011111111111111100000000000100000000000000000000000000000000000000000000000000
0000000000000000000000000000000000000000001000000000010000000000000100000000000110000000000000000000000000000000000000000000000000
0000000000000000000000000000000000000000011000000000010000000000000100000000000010000000000000000000000000000000000000000000000000
0000000000000000000000000000000000000000010000000000010000000000000100000000000011000000000000000000000000000000000000000000000000
0000000000000000000000000000000000000000110000000000010000000000000100000000000001000000000000000000000000000000000000000000000000
0000000000000000000000000000000000000000100000000000010000000000000100000000000001000000000000000000000000000000000000000000000000
0000000000000000000000000000000000000000100000000000010000000000000100000000000001100000000000000000000000000000000000000000000000
0000000000000000000000000000000000000000111111100000010000000000111111111111111111100000000000000000000000000000000000000000000000
0000000000000000000000000000000000000001111111111111110000000000100000000000000000100000000000000000000000000000000000000000000000
0000000000000000000000000000000000000001000000000010000000000000100000000000000000100000000000000000000000000000000000000000000000
0000000000000000000000000000000000000001000000000010000000000000100000000000000000100000000000000000000000000000000000000000000000
0000000000000000000000000000000000000001000000000010000000000000100000000000000000100000000000000000000000000000000000000000000000
0000000000000000000000000000000000000001000000000010000000000000100000000000000000100000000000000000000000000000000000000000000000
0000000000000000000000000000000000000001000000000010000000000000100000000000000000100000000000000000000000000000000000000000000000
0000000000000000000000000000000000000001100000000010000000000000100000000000000000100000000000000000000000000000000000000000000000
0000000000000000000000000000000000000001100000000010000000000000100000000000000000100000000000000000000000000000000000000000000000
0000000000000000000000000000000000000000111111111111111111111111111111100000000000100000000000000000000000000000000000000000000000
0000000000000000000000000000000000000000100000000000000011000000000000110000000001100000000000000000000000000000000000000000000000
0000000000000000000000000000000000000000100000000000000010000000000000010000000001000000000000000000000000000000000000000000000000
0000000000000000000000000000000000000000110000000000000010000000000000010000000001000000000000000000000000000000000000000000000000
0000000000000000000000000000000000000000010000000000000010000000000000010000000011000000000000000000000000000000000000000000000000
0000000000000000000000000000000000000000011000000000000010000000000000010000000010000000000000000000000000000000000000000000000000
0000000000000000000000000000000000000000001000000000000010000000000000010000000110000000000000000000000000000000000000000000000000
0000000000000000000000000000000000000000001100000000000011000000000000110000001100000000000000000000000000000000000000000000000000
0000000000000000000000000000000000000000000110000000000011111111111111111111111000000000000000000000000000000000000000000000000000
0000000000000000000000000000000000000000000010000000000010000000000000000000011000000000000000000000000000000000000000000000000000
0000000000000000000000000000000000000000000001000000000010000000000000000000110000000000000000000000000000000000000000000000000000
0000000000000000000000000000000000000000000000100000000010000000000000000001100000000000000000000000000000000000000000000000000000
0000000000000000000000000000000000000000000000011000000010000000000000000011000000000000000000000000000000000000000000000000000000
0000000000000000000000000000000000000000000000001100000010000000000000001110000000000000000000000000000000000000000000000000000000
0000000000000000000000000000000000000000000000000111000010000000000000011000000000000000000000000000000000000000000000000000000000
0000000000000000000000000000000000000000000000000001110010000000000011100000000000000000000000000000000000000000000000000000000000
0000000000000000000000000000000000000000000000000000111111000000111111000000000000000000000000000000000000000000000000000000000000
0000000000000000000000000000000000000000000000000001111111111111111111110000000000000000000000000000000000000000000000000000000000
0000000000000000000000000000000000000000000000000001000000000000000000010000000000000000000000000000000000000000000000000000000000
0000000000000000000000000000000000000000000000000001000000000000000000010000000000000000000000000000000000000000000000000000000000
0000000000000000000000000000000000000000000000000001000000000000000000010000000000000000000000000000000000000000000000000000000000
0000000000000000000000000000000000000000000000000001000000000000000000010000000000000000000000000000000000000000000000000000000000
0000000000000000000000000000000000000000000000000011010000000000000000011000000000000000000000000000000000000000000000000000000000
0000000000000000000000000000000000000000000000000111111111111111111111111100000000000000000000000000000000000000000000000000000000
0000000000000000000000000000000000000000000000000100000000000000001000000100000000000000000000000000000000000000000000000000000000
0000000000000000000000000000000000000000000000000100000000000000001000000100000000000000000000000000000000000000000000000000000000
0000000000000000000000000000000000000000000000000100000000000000001000000100000000000000000000000000000000000000000000000000000000
0000000000000000000000000000000000000000000000000100000000000000001000000100000000000000000000000000000000000000000000000000000000
0000000000000000000000000000000000000000000000000100000000000000001000000100000000000000000000000000000000000000000000000000000000
0000000000000000000000000000000000000000000000000100000001111111111000000100000000000000000000000000000000000000000000000000000000
0000000000000000000000000000000000000000000000000100000001000000001000000100000000000000000000000000000000000000000000000000000000
0000000000000000000000000000000000000000000000000100000001000000001000000100000000000000000000000000000000000000000000000000000000
0000000000000000000000000000000000000000000000000110000011000000001000000100000000000000000000000000000000000000000000000000000000
0000000000000000000000000000000000000000000000001111111111000000001111111110000000000000000000000000000000000000000000000000000000
0000000000000000000000000000000000000000000000001000000001000000000000000011000000000000000000000000000000000000000000000000000000
0000000000000000000000000000000000000000000000001000000001000000000000000001000000000000000000000000000000000000000000000000000000
0000000000000000000000000000000000000000000000001000000001000000000000000011000000000000000000000000000000000000000000000000000000
0000000000000000000000000000000000000000000000001000000001000000000000000011000000000000000000000000000000000000000000000000000000
0000000000000000000000000000000000000000000000001000000001000000000030000011000000000000000000000000000000000000000000000000000000
0000000000000000000000000000000000000000000000001000000001000000000000000011000000000000000000000000000000000000000000000000000000
0000000000000000000000000000000000000000000000001000000001000000000000000001000000000000200000000000000000000000000000000000000000
0000000000000000000000000000000000000000000000001111111111111111111111111111000000000000000000000000000000000000000000000000000000
0000000000000000000000000000000000000000000000001000000000000000000000000011000000000000000000000000000000000000000000000000000000
0000000000000000000000000000111111111111111111111111111111111111111111111111111111111111111111111111111111111111100000000000000000
0000000000000000000000000000000000000000000000000000000000000000000000000000000000000000000000000000000000000000000000000000000000
